wojewodztwo;liczba_nowych_zakazen;liczba_ponownych_zakazen;liczba_wszystkich_zakazen;liczba_nowych_zakazen_na_10_tys_mieszkancow;liczba_ponownych_zakazen_na_10_tys_mieszkancow;liczba_wszystkich_zakazen_na_10_tys_mieszkancow;zgony;zgony_w_wyniku_covid_bez_chorob_wspolistniejacych;zgony_w_wyniku_covid_i_chorob_wspolistniejacych;liczba_zlecen_poz;liczba_ozdrowiencow;liczba_osob_objetych_kwarantanna;liczba_wykonanych_testow;liczba_testow_z_wynikiem_pozytywnym;liczba_testow_z_wynikiem_negatywnym;liczba_pozostalych_testow;teryt;stan_rekordu_na
Ca³y kraj;189;87;276;0.05;0.02;0.07;1;0;1;343;0;0;1281;293;988;0;t00;2023-09-28
dolnoœl¹skie;17;4;21;0.06;0.01;0.07;0;0;0;23;0;0;88;21;67;0;t02;2023-09-28
kujawsko-pomorskie;11;7;18;0.05;0.03;0.09;0;0;0;11;0;0;40;19;21;0;t04;2023-09-28
lubelskie;24;11;35;0.11;0.05;0.17;1;0;1;27;0;0;74;49;25;0;t06;2023-09-28
lubuskie;4;0;4;0.04;0;0.04;0;0;0;6;0;0;19;4;15;0;t08;2023-09-28
³ódzkie;8;0;8;0.03;0;0.03;0;0;0;19;0;0;37;8;29;0;t10;2023-09-28
ma³opolskie;16;7;23;0.05;0.02;0.07;0;0;0;44;0;0;91;24;67;0;t12;2023-09-28
mazowieckie;36;16;52;0.07;0.03;0.10;0;0;0;57;0;0;425;52;373;0;t14;2023-09-28
opolskie;3;3;6;0.03;0.03;0.06;0;0;0;3;0;0;52;6;46;0;t16;2023-09-28
podkarpackie;8;1;9;0.04;0.00;0.04;0;0;0;21;0;0;59;9;50;0;t18;2023-09-28
podlaskie;10;6;16;0.08;0.05;0.14;0;0;0;16;0;0;40;16;24;0;t20;2023-09-28
pomorskie;8;5;13;0.03;0.02;0.06;0;0;0;22;0;0;59;13;46;0;t22;2023-09-28
œl¹skie;11;8;19;0.02;0.02;0.04;0;0;0;31;0;0;92;19;73;0;t24;2023-09-28
œwiêtokrzyskie;6;3;9;0.05;0.02;0.07;0;0;0;3;0;0;15;9;6;0;t26;2023-09-28
warmiñsko-mazurskie;5;1;6;0.04;0.01;0.04;0;0;0;18;0;0;41;6;35;0;t28;2023-09-28
wielkopolskie;10;6;16;0.03;0.02;0.05;0;0;0;16;0;0;35;17;18;0;t30;2023-09-28
zachodniopomorskie;8;8;16;0.05;0.05;0.09;0;0;0;26;0;0;59;16;43;0;t32;2023-09-28
